XXXXXXXXEXXXXXXXXXXXXXXXXXXXXXXXXXXX
X    X           XX                X
X  XXX           XX                X
X                                  X
X                                  X
X                                  X
X                                  X
E                                  E
E                                  E
X                                  X
X                                  X
X                                  X
X                                  X
X                                  X
XXXXXXXXEXXXXXXXXXXXXXXXXXXXXXXXXXXX
