XXXXXXXXEXXXXXXXXX
X    X           X
X  XXX           X
X                X
X                X
E                E
X                X
X                X
X                X
X                X
XXXXXXXXEXXXXXXXXX
