XXXXXXXXEEXXXXXXXXXXXXXXXXXXXXXXXXXX
X                                  X
X            W              W      X
X                                  X
X                                  X
X    W                             X
X                         W        X
E                                  E
E                                  E
X                                  X
X                                  X
X        W           W             X
X                                  X
X                               W  X
XXXXXXXXEEXXXXXXXXXXXXXXXXXXXXXXXXXX
