XXXXXXXXXXXXXXXEEXXXXXXXXXXXXXXXXXXX
X                                  X
X    W                             X
X       RRR                   W    X
XRRRRRRRRRR          RRRR          X
XRRRRRR              RRRRRRRRR     X
X             I       RRRRRRRRRRRRRX
E          RRRRR   W               E
E         RRRRRRR                  E
X             RR                   X
X                                  X
X    W   RRR       RRRR      RRRRRRX
X     RRRRRR       RRRRR       RRRRX
XRRRRRRRRRRR       RRRRRRRR W      X
XXXXXXXXXXXXXXXEEXXXXXXXXXXXXXXXXXXX
