XXXXXXXXEXXXXXXXXXXXXXXXXXXXXXXXXXXX
X   BX           XX                X
X  XXX           XX     W          X
X                                  X
X                           W      X
X                                  X
X                                  X
E                                  E
E               IIIIII             E
X                                  X
X                                  X
X                                  X
X                                  X
X    W                          W  X
XXXXXXXXEXXXXXXXXXXXXXXXXXXXXXXXXXXX
