XXXXXXXXEEXXXXXXXXXXXXXXXXXXXXXXXXXX
X                                  X
X                                  X
X                                  X
X                                  X
X                                  X
X                                  X
E                                  E
E                                  E
X                                  X
X                                  X
X                                  X
X                                  X
X                               W  X
XXXXXXXXEEXXXXXXXXXXXXXXXXXXXXXXXXXX
