XXXXXXXXEXXXXXXXXXXXXXXXXXXXXXXXXXXX
X   BX           XX                X
X  XXX           XX                X
X                                  X
X                                  X
X                                  X
X                                  X
E                                  E
E               IIIIII             E
X                                  X
X                                  X
X                                  X
X                                  X
X                               W  X
XXXXXXXXEXXXXXXXXXXXXXXXXXXXXXXXXXXX
