XXXXXXXXEXXXXXXXXXXXXXXXXXXXXXXXXXXX
X                                  X
X                                  X
X                                  X
X                                  X
X                                  X
X                                  X
E                                  E
E                                  E
X                   X              X
X               XXXXX              X
X                   X              X
X                   X              X
X                   X              X
XXXXXXXXEXXXXXXXXXXXXXXXXXXXXXXXXXXX
