XXXXXXXXEXXXXXXXXXXXXXXXXXXXXXXXXXXX
X                                  X
X    W                             X
X                                  X
X                                  X
X                                  X
X                                  X
E                                  E
E                                  E
X                   X              X
X               XXXXX              X
X                  BX              X
X                   X        W     X
X                   X              X
XXXXXXXXEXXXXXXXXXXXXXXXXXXXXXXXXXXX
