XXXXXXXXXXXXXXXEEXXXXXXXXXXXXXXXXXXX
X   RR                       R     X
X  RR    W                W  RR    X
X RR              I           RRRRRX
XRR            RRRRR               X
XR          RRRR    RRR            X
X          RR          R           X
E         RR            R          E
E         R            RR          E
X         RRRRRR      R           RX
X              RRRRRRRR          RRX
XRRR                            RR X
X  RRR W                       RR  X
X    RR                    W  RR   X
XXXXXXXXXXXXXXXEEXXXXXXXXXXXXXXXXXXX
