XXXXXXXXEEXXXXXXXXXXXXXXXXXXXXXXXXXX
X                                  X
X    W                             X
X                                  X
X                                  X
X                                  X
X                                  X
E                                  E
E                                  E
X                   X              X
X               XXXXX       W   W  X
X                  BX              X
X               W   X    W   W     X
X    W    W         X              X
XXXXXXXXEEXXXXXXXXXXXXXXXXXXXXXXXXXX
