XXXXXXXXXXXXXXXEEXXXXXXXXXXXXXXXXXXX
XRRRRR                             X
XRRRR    W                W        X
XRRR                               X
XRR                                X
XR            RRRRRRRRR            X
X           RRRRRRRRRRRRR          X
E            RRRR   RRRR           E
E             RR     RR            E
X            RRRR   RRRR          RX
X           RRRRRRRRRRRRR        RRX
X            RRRRRRRRRRR     W  RRRX
X      W                       RRRRX
X  W                       W  RRRRRX
XXXXXXXXXXXXXXXEEXXXXXXXXXXXXXXXXXXX
