XXXXXXXXXXXXXXXEEXXXXXXXXXXXXXXXXXXX
X   RR                       R     X
X  RR    W                W  R     X
X RR              I          RRRRRRX
XRR                                X
XR        RRRRRRRRRRRRRRR          X
X         R  R       R  R          X
E         R  R       R  R          E
E         RRRRRRRRRRRRRRR          E
X     W   R  R       R  R         RX
X         RRRRRRRRRRRRRRR        RRX
XRRRR                        W  RR X
X   R  W                       RR  X
X   R                      W  RR   X
XXXXXXXXXXXXXXXEEXXXXXXXXXXXXXXXXXXX
