XXXXXXXXXXXXXXXEEXXXXXXXXXXXXXXXXXXX
XRRRRRRRRRRRR      RRRRRRRRRRRRRRRRX
XRRRRRRRRRRRR      RRRRRRRRRRRRRRRRX
XRRRRRRRRRRRR      RRRRRRRRRRRRRRRRX
XRRRRRRRRRRR        RRRRRRRRRRRRRRRX
XRRRRRRRRR            RRRRRRRRRRRRRX
X             W W                  X
E         W   I     W              E
E             W W                  E
X                                  X
XRRRRRRRRR            RRRRRRRRRRRRRX
XRRRRRRRRRRR        RRRRRRRRRRRRRRRX
XRRRRRRRRRRRR      RRRRRRRRRRRRRRRRX
XRRRRRRRRRRRR      RRRRRRRRRRRRRRRRX
XXXXXXXXXXXXXXXEEXXXXXXXXXXXXXXXXXXX
