XXXXXXXXXXXXXXXEEXXXXXXXXXXXXXXXXXXX
XRRRRRRRRRRRR      RRRRRRRRRRRRRRRRX
XRRRRRRRRRRRR      RRRRRRRRRRRRRRRRX
XRRRRRRRRRRRR      RRRRRRRRRRRRRRRRX
XRRRRRRRRRRRR      RRRRRRRRRRRRRRRRX
XRRRRRRRRRRRR      RRRRRRRRRRRRRRRRX
X             W W                  X
E         W         W              E
E             W W                  E
X                                  X
XRRRRRRRRRRRR      RRRRRRRRRRRRRRRRX
XRRRRRRRRRRRR      RRRRRRRRRRRRRRRRX
XRRRRRRRRRRRR      RRRRRRRRRRRRRRRRX
XRRRRRRRRRRRR      RRRRRRRRRRRRRRRRX
XXXXXXXXXXXXXXXEEXXXXXXXXXXXXXXXXXXX
