XXXXXXXXXXXXXXXEEXXXXXXXXXXXXXXXXXXX
XRRRRRRRRRRRR      RRRRRRRRRRRRRRRRX
XRRRRRRRRRRRR      RRRRRRRRRRRRRRRRX
XRRRRRRRRRRRR      RRRRRRRRRRRRRRRRX
XRRRRRRRRRRR        RRRRRRRRRRRRRRRX
XRRRRRRRRR W        W RRRRRRRRRRRRRX
X                                  X
E             I                    E
E                                  E
X                                  X
XRRRRRRRRR W        W RRRRRRRRRRRRRX
XRRRRRRRRRRR        RRRRRRRRRRRRRRRX
XRRRRRRRRRRRR      RRRRRRRRRRRRRRRRX
XRRRRRRRRRRRR      RRRRRRRRRRRRRRRRX
XXXXXXXXXXXXXXXEEXXXXXXXXXXXXXXXXXXX
