XXXXXXXXXXXXXXXEEXXXXXXXXXXXXXXXXXXX
X                            W     X
X   W                              X
X      R   RRRRRRRRRRRRR    RRRRRRRX
X  RRRRR   RRR     RRRRR      W  RRX
XRRRRRRR   RR         RR         RRX
X          R    I      R    R      X
E                      R    R      E
E                W     R    RR     E
XRRRR    RRRR          RRRRRRR     X
XRR      RRRRRR        RR   RR     X
XR     RRRRRRRRRRR     R    RR     X
XRR                                X
XR  W                           W  X
XXXXXXXXXXXXXXXEEXXXXXXXXXXXXXXXXXXX
