XXXXXXXXXXXXXXXEEXXXXXXXXXXXXXXXXXXX
X            R                RR   X
X           RR               W RR  X
X         RRR               RRRRRR X
XRRRRRRRRRRRRR               R   RRX
X          W RR              R     X
X                  I               X
E                 W RRRRRRRW       E
E                   R     RR       E
X          RRRR     RR     RRR     X
XRRR      RR  R      RR      RRR   X
X  RRRR  RR           RRRR     RRRRX
X     RRRR               RR        X
X        RRRR           W R        X
XXXXXXXXXXXXXXXEEXXXXXXXXXXXXXXXXXXX
