XXXXXXXXXXXXXXXEEXXXXXXXXXXXXXXXXXXX
XRRRRRRRRRRRRRR  RRRRRRRRRRRRRRRRRRX
XRRRRRRRRRRRRRR  RRRRRRRRRRRRRRRRRRX
XRRRR                          RRRRX
XRR    W                    W    RRX
XRR           W      W           RRX
XRR             I                RRX
E            W     W               E
E                                  E
XRR                              RRX
XRR      W                  W    RRX
XRRRR                          RRRRX
XRRRRRRRRRRRRRR  RRRRRRRRRRRRRRRRRRX
XRRRRRRRRRRRRRR  RRRRRRRRRRRRRRRRRRX
XXXXXXXXXXXXXXXEEXXXXXXXXXXXXXXXXXXX
