XXXXXXXXXXXXXXXEEXXXXXXXXXXXXXXXXXXX
XRRRRRRRRRRRRRR  RRRRRRRRRRRRRRRRRRX
XRRRRRRRRRRRRRR  RRRRRRRRRRRRRRRRRRX
XRRRR   W                  W   RRRRX
XRR                              RRX
XRR                              RRX
XRR             I                RRX
E                 W                E
E                                  E
XRR                              RRX
XRR                              RRX
XRRRR   W                   W  RRRRX
XRRRRRRRRRRRRRR  RRRRRRRRRRRRRRRRRRX
XRRRRRRRRRRRRRR  RRRRRRRRRRRRRRRRRRX
XXXXXXXXXXXXXXXEEXXXXXXXXXXXXXXXXXXX
