XXXXXXXXXXXXXXXEEXXXXXXXXXXXXXXXXXXX
XRRRRRRRRRRRRRR  RRRRRRRRRRRRRRRRRRX
XRRRRRRRRRRRRRR  RRRRRRRRRRRRRRRRRRX
XRR                              RRX
XRR    W                    W    RRX
XRR           W      W           RRX
XRR             I                RRX
E            W     W               E
E                                  E
XRR                              RRX
XRR      W                  W    RRX
XRR                              RRX
XRRRRRRRRRRRRRR  RRRRRRRRRRRRRRRRRRX
XRRRRRRRRRRRRRR  RRRRRRRRRRRRRRRRRRX
XXXXXXXXXXXXXXXEEXXXXXXXXXXXXXXXXXXX
